ALBERTSONS	Groceries
VERIZON*RECURRINGPAY	Bill
RACETRAC	Gas
CAPELLA GROUP	Income
SHELL Service Station	Gas
SWTOR	Bill
SUPERCUTS	Other
ATMOS ENERGY	Bill
FINA EXPRESS	Gas
HyundaiKia	Bill
CHICK-FIL-A	Entertainment
TACO BELL	Entertainment
APPLEBEES	Entertainment
DAIRY QUEEN	Entertainment
KROGER	Groceries
SONIC DRIVE IN	Entertainment
HOB-LOB	Other
PIZZA HUT	Entertainment
FUDDRUCKER	Entertainment
JASONS DELI	Entertainment
PALIOS PIZZA	Entertainment
BLOCKBUSTER	Bill
JACK IN THE B	Entertainment
DOUBLE DAVE	Entertainment
WENDY'S	Entertainment
ON THE BORDER	Entertainment
TRION WORLDS	Bill
LITTLE CAESARS	Entertainment
BLIZZARD ENT*WOW SUB	Bill
CHARTER COMM	Bill
EXXONMOBIL	Gas
DICKEYS	Entertainment
YOGURT STORY	Entertainment
MCDONALD'S	Entertainment
BETH MARIES	Entertainment
TEKSYSTEMS	Income
UNIV OF NORTH	Income
MICROSOFT *XBOX LIVE	Bill
